;touches;passes_def;passes_mid;passes_att;passes_forward;passes_backward;passes_vertical;passes_left;passes_right;passes_horizontal;passes_long;passes_short;crosses;shots;goals_scored;goals_received;possession;match;Link
grêmio;688;76;336;165;332;242;574;291;285;576;35;542;15;17;3;3;63;;https://1xbet.whoscored.com/Matches/1457893/Live/Brazil-Brasileirão-2020-Gremio-Santos-FC
santos;459;91;154;104;217;131;348;161;188;349;37;312;16;9;3;3;37;;https://1xbet.whoscored.com/Matches/1457893/Live/Brazil-Brasileirão-2020-Gremio-Santos-FC
Fortaleza;544;93;243;115;253;197;450;233;218;451;64;387;18;11;0;2;44;Round 1 - Fortaleza x Athletico Paranaense;https://1xbet.whoscored.com/Matches/1457761/Live/Brazil-Brasileirão-2020-Fortaleza-Athletico-Paranaense
Athletico Paranaense;682;181;294;104;324;253;577;294;284;578;62;517;9;13;2;0;56;Round 1 - Fortaleza x Athletico Paranaense;https://1xbet.whoscored.com/Matches/1457761/Live/Brazil-Brasileirão-2020-Fortaleza-Athletico-Paranaense
Coritiba;564;87;241;88;295;117;412;202;212;414;55;361;12;2;0;1;43;Round 1 - Coritiba x Internacional;https://1xbet.whoscored.com/Matches/1457568/Live/Brazil-Brasileirão-2020-Coritiba-Internacional
Internacional;696;83;298;177;332;225;557;283;274;557;61;497;30;11;1;0;57;Round 1 - Coritiba x Internacional;https://1xbet.whoscored.com/Matches/1457568/Live/Brazil-Brasileirão-2020-Coritiba-Internacional
Sport Recife;526;43;213;109;232;129;361;180;181;361;58;307;13;9;3;2;40;Round 1 - Sport Recife x Ceara;https://1xbet.whoscored.com/Matches/1457569/Live/Brazil-Brasileirão-2020-Sport-Recife-Ceara
Ceara;671;103;299;127;345;183;528;261;266;527;47;482;12;11;2;3;60;Round 1 - Sport Recife x Ceara;https://1xbet.whoscored.com/Matches/1457569/Live/Brazil-Brasileirão-2020-Sport-Recife-Ceara
Santos;624;145;249;90;334;147;481;246;236;482;56;428;19;10;1;1;54;Round 1 - Santos x Red Bull;https://1xbet.whoscored.com/Matches/1457762/Live/Brazil-Brasileirão-2020-Santos-FC-Red-Bull-Bragantino
Red Bull;561;68;173;180;283;134;417;220;197;417;49;372;19;18;1;1;46;Round 1 - Santos x Red Bull;https://1xbet.whoscored.com/Matches/1457762/Live/Brazil-Brasileirão-2020-Santos-FC-Red-Bull-Bragantino
Flamengo;725;155;273;146;360;211;571;299;273;572;56;518;19;18;0;1;62;Round 1 - Flamengo x Altetico MG;https://1xbet.whoscored.com/Matches/1457559/Live/Brazil-Brasileirão-2020-Flamengo-Atletico-MG
Atletico Mg;497;88;154;99;222;118;340;185;154;339;64;500;6;10;1;0;38;Round 1 - Flamengo x Altetico MG;https://1xbet.whoscored.com/Matches/1457559/Live/Brazil-Brasileirão-2020-Flamengo-Atletico-MG
Gremio;695;57;291;193;354;184;538;276;264;540;54;487;17;15;1;0;53;Round 1 - Gremio x Fluminense;https://1xbet.whoscored.com/Matches/1457570/Live/Brazil-Brasileirão-2020-Gremio-Fluminense
Fluminense;658;127;247;107;307;172;479;248;233;481;56;425;15;10;0;1;48;Round 1 - Gremio x Fluminense;https://1xbet.whoscored.com/Matches/1457570/Live/Brazil-Brasileirão-2020-Gremio-Fluminense
Athletico Paranaense;907;142;449;179;454;314;768;371;398;769;78;692;16;19;2;1;79;Round 2 - Athletico Paranaense x Goias;https://1xbet.whoscored.com/Matches/1457560/Live/Brazil-Brasileirão-2020-Athletico-Paranaense-Goias
Goias;372;25;105;95;146;79;225;132;92;224;48;177;9;13;1;2;22;Round 2 - Athletico Paranaense x Goias;https://1xbet.whoscored.com/Matches/1457560/Live/Brazil-Brasileirão-2020-Athletico-Paranaense-Goias
Atletico Mg;721;85;265;221;362;207;569;282;282;564;52;519;30;25;3;2;55;Round 2 - Atletico Mg x Corinthians;https://1xbet.whoscored.com/Matches/1457563/Live/Brazil-Brasileirão-2020-Atletico-MG-Corinthians
Corinthians;628;151;215;90;304;150;454;237;214;451;69;386;10;8;2;3;45;Round 2 - Atletico Mg x Corinthians;https://1xbet.whoscored.com/Matches/1457563/Live/Brazil-Brasileirão-2020-Atletico-MG-Corinthians
Red Bull;747;70;280;264;400;213;613;313;299;612;42;572;30;23;1;1;54;Round 2 - Red Bull x Botafogo;https://1xbet.whoscored.com/Matches/1457564/Live/Brazil-Brasileirão-2020-Red-Bull-Bragantino-Botafogo-RJ
Botafogo;651;148;270;95;333;179;512;266;244;510;51;462;16;9;1;1;46;Round 2 - Red Bull x Botafogo;https://1xbet.whoscored.com/Matches/1457564/Live/Brazil-Brasileirão-2020-Red-Bull-Bragantino-Botafogo-RJ
Bahia;597;81;246;128;307;148;455;254;199;453;52;403;12;12;1;0;46;Round 2 - Bahia x Coritiba;https://1xbet.whoscored.com/Matches/1457561/Live/Brazil-Brasileirão-2020-Bahia-Coritiba
Coritiba;688;143;235;156;350;182;532;266;268;534;57;477;29;15;0;1;54;Round 2 - Bahia x Coritiba;https://1xbet.whoscored.com/Matches/1457561/Live/Brazil-Brasileirão-2020-Bahia-Coritiba
Atletico GO;469;76;134;119;229;98;327;167;158;325;52;277;24;13;3;0;35;Round 2 - Atletico GO x Flamengo;https://1xbet.whoscored.com/Matches/1457575/Live/Brazil-Brasileirão-2020-Atletico-GO-Flamengo
Flamengo;746;73;334;199;373;227;600;315;288;603;32;574;23;9;0;3;65;Round 2 - Atletico GO x Flamengo;https://1xbet.whoscored.com/Matches/1457575/Live/Brazil-Brasileirão-2020-Atletico-GO-Flamengo
Fluminense;629;103;235;123;301;158;459;216;243;459;53;408;12;10;1;1;52;Round 2 - Fluminense x Palmeiras;https://1xbet.whoscored.com/Matches/1457567/Live/Brazil-Brasileirão-2020-Fluminense-Palmeiras
Palmeiras;574;70;242;118;280;148;428;199;229;428;49;381;13;9;1;1;48;Round 2 - Fluminense x Palmeiras;https://1xbet.whoscored.com/Matches/1457567/Live/Brazil-Brasileirão-2020-Fluminense-Palmeiras
Ceara;607;97;248;116;286;175;461;148;213;361;58;403;13;11;1;1;42;Round 2 - Ceara x Gremio;https://1xbet.whoscored.com/Matches/1457574/Live/Brazil-Brasileirão-2020-Ceara-Gremio
Gremio;774;79;364;176;381;238;619;320;298;618;47;572;19;14;1;1;58;Round 2 - Ceara x Gremio;https://1xbet.whoscored.com/Matches/1457574/Live/Brazil-Brasileirão-2020-Ceara-Gremio
Sao Paulo;628;116;279;114;313;195;508;260;247;507;58;451;16;13;1;0;52;Round 2 - Sao Paulo x Fortaleza;https://1xbet.whoscored.com/Matches/1457565/Live/Brazil-Brasileirão-2020-Sao-Paulo-Fortaleza
Fortaleza;443;113;258;106;295;180;475;230;245;475;57;420;14;12;0;1;48;Round 2 - Sao Paulo x Fortaleza;https://1xbet.whoscored.com/Matches/1457565/Live/Brazil-Brasileirão-2020-Sao-Paulo-Fortaleza
Internacional;712;83;272;209;344;220;564;272;289;561;55;509;33;25;2;0;58;Round 2 - Internacional x Santos;https://1xbet.whoscored.com/Matches/1457562/Live/Brazil-Brasileirão-2020-Internacional-Santos-FC
Santos;607;147;198;66;285;124;409;184;221;405;45;366;10;6;0;2;42;Round 2 - Internacional x Santos;https://1xbet.whoscored.com/Matches/1457562/Live/Brazil-Brasileirão-2020-Internacional-Santos-FC
Vasco;556;84;220;96;249;151;400;188;210;398;45;355;10;9;2;0;46;Round 2 - Vasco x Sport Recife;https://1xbet.whoscored.com/Matches/1457566/Live/Brazil-Brasileirão-2020-Vasco-da-Gama-Sport-Recife
Sport Recife;626;68;245;160;304;167;471;247;226;473;35;438;25;13;0;2;54;Round 2 - Vasco x Sport Recife;https://1xbet.whoscored.com/Matches/1457566/Live/Brazil-Brasileirão-2020-Vasco-da-Gama-Sport-Recife
Gremio;718;47;248;256;340;207;547;266;283;549;40;511;36;24;0;0;48;Round 3 - Gremio x Corinthians;https://1xbet.whoscored.com/Matches/1457584/Live/Brazil-Brasileirão-2020-Gremio-Corinthians
Corinthians;771;132;354;109;358;232;590;310;284;594;47;548;12;5;0;0;52;Round 3 - Gremio x Corinthians;https://1xbet.whoscored.com/Matches/1457584/Live/Brazil-Brasileirão-2020-Gremio-Corinthians
Coritiba;461;97;143;95;229;105;334;174;160;334;56;279;15;9;0;1;35;Round 3 - Coritiba x Flamengo;https://1xbet.whoscored.com/Matches/1457582/Live/Brazil-Brasileirão-2020-Coritiba-Flamengo
Flamengo;732;122;278;179;346;233;579;297;281;578;61;518;18;18;1;0;65;Round 3 - Coritiba x Flamengo;https://1xbet.whoscored.com/Matches/1457582/Live/Brazil-Brasileirão-2020-Coritiba-Flamengo
Palmeiras;891;106;386;230;458;262;720;353;367;720;44;678;26;12;1;1;65;Round 3 - Palmeiras x Goias;https://1xbet.whoscored.com/Matches/1457587/Live/Brazil-Brasileirão-2020-Palmeiras-Goias
Goias;568;49;223;122;257;135;392;214;179;393;70;324;6;11;1;1;35;Round 3 - Palmeiras x Goias;https://1xbet.whoscored.com/Matches/1457587/Live/Brazil-Brasileirão-2020-Palmeiras-Goias
Atletico Mg;644;111;243;164;327;190;517;260;253;513;67;451;21;11;2;0;61;Round 3 - Atletico MG x Ceara;https://1xbet.whoscored.com/Matches/1457585/Live/Brazil-Brasileir%C3%A3o-2020-Atletico-MG-Ceara
Ceara;478;76;145;114;224;111;335;158;173;331;70;265;8;3;0;2;39;Round 3 - Atletico MG x Ceara;https://1xbet.whoscored.com/Matches/1457585/Live/Brazil-Brasileir%C3%A3o-2020-Atletico-MG-Ceara
Vasco;554;108;209;93;253;155;408;211;197;408;60;350;8;8;2;1;40;Round 3 - Vasco x Sao Paulo;https://1xbet.whoscored.com/Matches/1457588/Live/Brazil-Brasileirão-2020-Vasco-da-Gama-Sao-Paulo
Sao Paulo;723;105;323;178;372;234;606;306;298;604;42;564;19;11;1;2;60;Round 3 - Vasco x Sao Paulo;https://1xbet.whoscored.com/Matches/1457588/Live/Brazil-Brasileirão-2020-Vasco-da-Gama-Sao-Paulo
Bahia;577;74;251;86;278;132;410;218;188;406;53;358;8;10;2;1;43;Round 3 - Bahia x Red Bull;https://1xbet.whoscored.com/Matches/1457583/Live/Brazil-Brasileirão-2020-Bahia-Red-Bull-Bragantino
Red Bull;694;64;266;226;360;192;552;276;279;555;52;504;24;16;1;2;57;Round 3 - Bahia x Red Bull;https://1xbet.whoscored.com/Matches/1457583/Live/Brazil-Brasileirão-2020-Bahia-Red-Bull-Bragantino
Fluminense;552;72;205;96;246;126;372;182;191;373;46;327;8;10;2;1;44;Round 3 - Fluminense x Internacional;https://1xbet.whoscored.com/Matches/1457589/Live/Brazil-Brasileirão-2020-Fluminense-Internacional
Internacional;612;91;264;121;304;169;473;232;241;473;60;416;16;9;1;2;57;Round 3 - Fluminense x Internacional;https://1xbet.whoscored.com/Matches/1457589/Live/Brazil-Brasileirão-2020-Fluminense-Internacional
Atletico GO;424;47;111;112;211;57;268;138;131;269;52;218;15;11;1;1;32;Round 3 - Atletico GO x Sport Recife;https://1xbet.whoscored.com/Matches/1457580/Live/Brazil-Brasileirão-2020-Atletico-GO-Sport-Recife
Sport Recife;695;92;284;204;367;208;575;292;286;578;39;541;36;15;1;1;68;Round 3 - Atletico GO x Sport Recife;https://1xbet.whoscored.com/Matches/1457580/Live/Brazil-Brasileirão-2020-Atletico-GO-Sport-Recife
Fortaleza;710;97;353;146;357;236;593;299;295;594;34;562;17;12;0;0;59;Round 3 - Fortaleza x Botafogo;https://1xbet.whoscored.com/Matches/1457581/Live/Brazil-Brasileirão-2020-Fortaleza-Botafogo-RJ
Botafogo;541;93;219;112;267;155;422;225;197;422;37;387;20;15;0;0;42;Round 3 - Fortaleza x Botafogo;https://1xbet.whoscored.com/Matches/1457581/Live/Brazil-Brasileirão-2020-Fortaleza-Botafogo-RJ
Santos;481;96;140;87;211;110;321;173;150;323;56;267;12;11;3;1;33;Round 3 - Santos x Athletico Paranaense;https://1xbet.whoscored.com/Matches/1457586/Live/Brazil-Brasileirão-2020-Santos-FC-Athletico-Paranaense
Athletico Paranaense;587;140;300;207;380;254;634;327;307;634;60;587;28;12;1;3;67;Round 3 - Santos x Athletico Paranaense;https://1xbet.whoscored.com/Matches/1457586/Live/Brazil-Brasileirão-2020-Santos-FC-Athletico-Paranaense
Red Bull;653;82;218;190;336;152;488;257;230;487;50;440;23;13;2;1;52;Round 4 - Red Bull x Fluminense;https://1xbet.whoscored.com/Matches/1457576/Live/Brazil-Brasileirão-2020-Red-Bull-Bragantino-Fluminense
Fluminense;641;93;228;145;305;160;465;248;217;465;38;428;21;9;1;2;48;Round 4 - Red Bull x Fluminense;https://1xbet.whoscored.com/Matches/1457576/Live/Brazil-Brasileirão-2020-Red-Bull-Bragantino-Fluminense
Flamengo;758;109;340;182;387;236;623;308;318;626;49;582;11;8;1;1;60;Round 4 - Flamengo x Gremio;https://1xbet.whoscored.com/Matches/1457579/Live/Brazil-Brasileirão-2020-Flamengo-Gremio
Gremio;537;55;262;100;273;142;415;216;196;412;52;365;7;10;1;1;40;Round 4 - Flamengo x Gremio;https://1xbet.whoscored.com/Matches/1457579/Live/Brazil-Brasileirão-2020-Flamengo-Gremio
Athletico Paranaense;654;145;275;93;303;206;509;254;256;510;82;431;18;6;0;1;55;Round 4 - Athletic Paranaense x Palmeiras;https://1xbet.whoscored.com/Matches/1457604/Live/Brazil-Brasileirão-2020-Athletico-Paranaense-Palmeiras
Palmeiras;568;86;192;142;262;157;419;217;201;418;70;350;26;10;1;0;45;Round 4 - Athletic Paranaense x Palmeiras;https://1xbet.whoscored.com/Matches/1457604/Live/Brazil-Brasileirão-2020-Athletico-Paranaense-Palmeiras
Goias;575;63;220;134;273;141;414;223;193;416;53;364;16;13;1;3;49;Round 4 - Goias x Fortaleza;https://1xbet.whoscored.com/Matches/1457602/Live/Brazil-Brasileirão-2020-Goias-Fortaleza
Fortaleza;601;144;196;106;284;161;445;236;207;443;66;380;12;13;3;1;52;Round 4 - Goias x Fortaleza;https://1xbet.whoscored.com/Matches/1457602/Live/Brazil-Brasileirão-2020-Goias-Fortaleza
Internacional;632;109;233;154;276;218;494;249;245;494;73;423;19;11;3;0;57;Round 4 - Internacional x Atletico GO;https://1xbet.whoscored.com/Matches/1457591/Live/Brazil-Brasileirão-2020-Internacional-Atletico-GO
Atletico GO;489;73;208;92;244;129;373;193;176;369;48;325;14;7;0;3;43;Round 4 - Internacional x Atletico GO;https://1xbet.whoscored.com/Matches/1457591/Live/Brazil-Brasileirão-2020-Internacional-Atletico-GO
Corinthians;775;89;352;199;417;220;637;325;315;640;42;598;31;23;3;1;63;Round 4 - Corinthians x Coritiba;https://1xbet.whoscored.com/Matches/1457590/Live/Brazil-Brasileirão-2020-Corinthians-Coritiba
Coritiba;532;126;188;78;268;120;388;181;210;391;49;343;8;9;1;3;37;Round 4 - Corinthians x Coritiba;https://1xbet.whoscored.com/Matches/1457590/Live/Brazil-Brasileirão-2020-Corinthians-Coritiba
Botafogo;413;46;107;83;183;53;236;120;114;234;75;161;15;10;2;1;26;Round 4 - Botafogo x Atletico Mg;https://1xbet.whoscored.com/Matches/1457578/Live/Brazil-Brasileirão-2020-Botafogo-RJ-Atletico-MG
Atletico Mg;820;70;317;280;408;256;664;334;329;663;31;636;33;31;1;2;74;Round 4 - Botafogo x Atletico Mg;https://1xbet.whoscored.com/Matches/1457578/Live/Brazil-Brasileirão-2020-Botafogo-RJ-Atletico-MG
Sport Recife;515;61;196;136;263;128;391;199;190;389;45;348;21;11;0;1;41;Round 4 - Sport Recife x Santos;https://1xbet.whoscored.com/Matches/1457605/Live/Brazil-Brasileirão-2020-Sport-Recife-Santos-FC
Santos;707;112;303;134;361;186;547;183;264;447;67;482;15;16;1;0;59;Round 4 - Sport Recife x Santos;https://1xbet.whoscored.com/Matches/1457605/Live/Brazil-Brasileirão-2020-Sport-Recife-Santos-FC
Ceara;699;60;255;230;326;218;544;277;265;542;51;494;43;22;0;3;58;Round 4 - Ceara x Vasco;https://1xbet.whoscored.com/Matches/1457603/Live/Brazil-Brasileirão-2020-Ceara-Vasco-da-Gama
Vasco;575;89;246;68;256;145;401;194;207;401;48;355;8;5;3;0;42;Round 4 - Ceara x Vasco;https://1xbet.whoscored.com/Matches/1457603/Live/Brazil-Brasileirão-2020-Ceara-Vasco-da-Gama
Sao Paulo;847;94;404;200;446;248;694;335;362;697;37;661;36;25;1;1;68;Round 4 - Sao Paulo x Bahia;https://1xbet.whoscored.com/Matches/1457577/Live/Brazil-Brasileirão-2020-Sao-Paulo-Bahia
Bahia;468;83;175;78;234;102;336;165;169;334;66;270;8;8;1;1;32;Round 4 - Sao Paulo x Bahia;https://1xbet.whoscored.com/Matches/1457577/Live/Brazil-Brasileirão-2020-Sao-Paulo-Bahia
Athletico Paranaense;822;127;379;169;416;258;674;336;337;673;74;601;37;15;0;1;66;Round 5 - Athletico Paranaense x Fluminense;https://1xbet.whoscored.com/Matches/1457594/Live/Brazil-Brasileirão-2020-Athletico-Paranaense-Fluminense
Fluminense;531;117;152;96;249;116;365;193;170;363;48;317;11;9;1;0;35;Round 5 - Athletico Paranaense x Fluminense;https://1xbet.whoscored.com/Matches/1457594/Live/Brazil-Brasileirão-2020-Athletico-Paranaense-Fluminense
Internacional;449;67;173;92;236;96;332;169;159;328;85;247;9;6;1;0;33;Round 5 - Internacional x Atletico Mg;https://1xbet.whoscored.com/Matches/1457596/Live/Brazil-Brasileirão-2020-Internacional-Atletico-MG
Atletico Mg;827;99;387;175;428;230;658;350;310;660;59;602;16;11;0;1;67;Round 5 - Internacional x Atletico Mg;https://1xbet.whoscored.com/Matches/1457596/Live/Brazil-Brasileirão-2020-Internacional-Atletico-MG
Goias;494;70;132;108;214;96;310;160;147;307;75;235;13;6;2;0;34;Round 5 - Goias x Atletico GO;https://1xbet.whoscored.com/Matches/1457592/Live/Brazil-Brasileirão-2020-Goias-Atletico-GO
Atletico GO;752;107;269;226;397;203;600;293;308;601;54;548;30;16;0;2;66;Round 5 - Goias x Atletico GO;https://1xbet.whoscored.com/Matches/1457592/Live/Brazil-Brasileirão-2020-Goias-Atletico-GO
Flamengo;826;99;352;236;434;249;683;345;337;682;36;651;26;15;1;1;67;Round 5 - Flamengo x Botafogo;https://1xbet.whoscored.com/Matches/1457601/Live/Brazil-Brasileirão-2020-Flamengo-Botafogo-RJ
Botafogo;494;102;151;97;230;120;350;172;178;350;55;295;14;7;1;1;33;Round 5 - Flamengo x Botafogo;https://1xbet.whoscored.com/Matches/1457601/Live/Brazil-Brasileirão-2020-Flamengo-Botafogo-RJ
Red Bull;549;48;171;163;266;114;380;190;187;377;36;346;32;15;1;2;47;Round 5 - Red Bull x Coritiba;https://1xbet.whoscored.com/Matches/1457598/Live/Brazil-Brasileirão-2020-Red-Bull-Bragantino-Coritiba
Coritiba;592;159;174;95;266;160;426;226;200;426;63;356;8;7;2;1;53;Round 5 - Red Bull x Coritiba;https://1xbet.whoscored.com/Matches/1457598/Live/Brazil-Brasileirão-2020-Red-Bull-Bragantino-Coritiba
Palmeiras;543;73;206;121;258;142;400;194;204;398;57;343;17;18;2;1;49;Round 5 - Palmeiras x Santos;https://1xbet.whoscored.com/Matches/1457599/Live/Brazil-Brasileirão-2020-Palmeiras-Santos-FC
Santos;551;105;190;124;287;131;418;211;207;418;54;365;19;8;1;2;56;Round 5 - Palmeiras x Santos;https://1xbet.whoscored.com/Matches/1457599/Live/Brazil-Brasileirão-2020-Palmeiras-Santos-FC
Vasco;611;120;237;94;278;173;451;231;217;448;51;400;11;10;0;0;47;Round 5 - Vasco x Gremio;https://1xbet.whoscored.com/Matches/1457600/Live/Brazil-Brasileirão-2020-Vasco-da-Gama-Gremio
Gremio;669;70;285;154;312;192;504;257;250;507;43;466;13;14;0;0;53;Round 5 - Vasco x Gremio;https://1xbet.whoscored.com/Matches/1457600/Live/Brazil-Brasileirão-2020-Vasco-da-Gama-Gremio
Sport Recife;674;72;305;170;329;217;546;280;165;445;57;490;13;10;0;1;55;Round 5 - Sport Recife x Sao Paulo;https://1xbet.whoscored.com/Matches/1457595/Live/Brazil-Brasileirão-2020-Sport-Recife-Sao-Paulo
Sao Paulo;585;161;196;96;283;167;450;218;234;452;49;404;14;11;1;0;45;Round 5 - Sport Recife x Sao Paulo;https://1xbet.whoscored.com/Matches/1457595/Live/Brazil-Brasileirão-2020-Sport-Recife-Sao-Paulo
Ceara;540;55;212;113;244;133;377;187;193;380;54;326;15;11;2;0;38;Round 5 - Ceara x Bahia;https://1xbet.whoscored.com/Matches/1457593/Live/Brazil-Brasileirão-2020-Ceara-Bahia
Bahia;756;98;347;156;383;217;600;315;284;599;48;553;32;16;0;2;62;Round 5 - Ceara x Bahia;https://1xbet.whoscored.com/Matches/1457593/Live/Brazil-Brasileirão-2020-Ceara-Bahia
Sao Paulo;815;193;282;182;387;269;656;346;310;656;65;592;28;15;1;0;57;Round 11 - Sao Paulo x Athletic Paranaense;https://1xbet.whoscored.com/Matches/1457659/Live/Brazil-Brasileirão-2020-Sao-Paulo-Athletico-Paranaense
Athletico Paranaense;656;146;256;97;314;185;499;253;244;497;64;435;9;5;0;1;43;Round 11 - Sao Paulo x Athletic Paranaense;https://1xbet.whoscored.com/Matches/1457659/Live/Brazil-Brasileirão-2020-Sao-Paulo-Athletico-Paranaense
Corinthians;739;117;315;190;404;216;620;329;291;620;49;573;14;21;1;1;59;Round 5 - Corinthians x Fortaleza;https://1xbet.whoscored.com/Matches/1457597/Live/Brazil-Brasileirão-2020-Corinthians-Fortaleza
Fortaleza;569;91;237;105;276;155;431;216;216;432;72;361;8;10;1;1;41;Round 5 - Corinthians x Fortaleza;https://1xbet.whoscored.com/Matches/1457597/Live/Brazil-Brasileirão-2020-Corinthians-Fortaleza
Botafogo;627;106;293;106;324;178;502;261;242;503;55;450;16;7;0;2;47;Round 6 - Botafogo x Internacional;https://1xbet.whoscored.com/Matches/1457607/Live/Brazil-Brasileirão-2020-Botafogo-RJ-Internacional
Internacional;682;138;309;115;321;240;561;289;272;561;68;494;7;7;2;0;53;Round 6 - Botafogo x Internacional;https://1xbet.whoscored.com/Matches/1457607/Live/Brazil-Brasileirão-2020-Botafogo-RJ-Internacional
Bahia;623;120;243;114;330;145;475;236;240;476;32;445;23;9;1;1;49;Round 6 - Bahia x Palmeiras;https://1xbet.whoscored.com/Matches/1457616/Live/Brazil-Brasileirão-2020-Bahia-Palmeiras
Palmeiras;646;86;258;148;310;180;490;247;244;491;55;437;11;11;1;1;51;Round 6 - Bahia x Palmeiras;https://1xbet.whoscored.com/Matches/1457616/Live/Brazil-Brasileirão-2020-Bahia-Palmeiras
Fluminense;636;160;213;112;319;166;485;254;228;482;46;439;9;12;2;1;46;Round 6 - Fluminense x Vasco;https://1xbet.whoscored.com/Matches/1457606/Live/Brazil-Brasileirão-2020-Fluminense-Vasco-da-Gama
Vasco;706;115;299;144;350;204;554;282;274;556;50;508;12;9;1;2;54;Round 6 - Fluminense x Vasco;https://1xbet.whoscored.com/Matches/1457606/Live/Brazil-Brasileirão-2020-Fluminense-Vasco-da-Gama
Fortaleza;740;152;332;135;359;260;619;318;301;619;75;544;16;13;3;0;59;Round 6 - Fortaleza x Red Bull;https://1xbet.whoscored.com/Matches/1457614/Live/Brazil-Brasileirão-2020-Fortaleza-Red-Bull-Bragantino
Red Bull;555;68;246;155;285;144;429;194;233;427;29;400;17;5;0;3;41;Round 6 - Fortaleza x Red Bull;https://1xbet.whoscored.com/Matches/1457614/Live/Brazil-Brasileirão-2020-Fortaleza-Red-Bull-Bragantino
Sao Paulo;647;106;234;149;302;187;489;247;239;486;52;437;25;14;2;1;54;Round 6 - Sao Paulo x Corinthians;https://1xbet.whoscored.com/Matches/1457620/Live/Brazil-Brasileirão-2020-Sao-Paulo-Corinthians
Corinthians;561;123;210;88;272;145;417;224;196;420;50;371;12;7;1;2;46;Round 6 - Sao Paulo x Corinthians;https://1xbet.whoscored.com/Matches/1457620/Live/Brazil-Brasileirão-2020-Sao-Paulo-Corinthians
Santos;630;107;245;123;301;169;470;217;256;473;45;430;20;22;0;1;52;Round 6 - Santos x Flamengo;https://1xbet.whoscored.com/Matches/1457619/Live/Brazil-Brasileirão-2020-Santos-FC-Flamengo
Flamengo;568;79;214;133;282;142;424;198;228;426;56;370;8;10;1;0;47;Round 6 - Santos x Flamengo;https://1xbet.whoscored.com/Matches/1457619/Live/Brazil-Brasileirão-2020-Santos-FC-Flamengo
Coritiba;741;121;329;147;386;207;593;302;292;594;66;531;15;13;1;0;58;Round 6 - Coritiba x Sport Recife;https://1xbet.whoscored.com/Matches/1457615/Live/Brazil-Brasileirão-2020-Coritiba-Sport-Recife
Sport Recife;572;65;217;155;294;143;437;225;211;436;60;377;25;6;0;1;42;Round 6 - Coritiba x Sport Recife;https://1xbet.whoscored.com/Matches/1457615/Live/Brazil-Brasileirão-2020-Coritiba-Sport-Recife
Atletico GO;572;126;171;120;287;129;416;206;209;415;51;366;20;14;0;2;54;Round 6 - Atletico GO x Ceara;https://1xbet.whoscored.com/Matches/1457613/Live/Brazil-Brasileirão-2020-Atletico-GO-Ceara
Ceara;512;47;178;127;229;122;351;165;186;351;67;285;17;13;2;0;46;Round 6 - Atletico GO x Ceara;https://1xbet.whoscored.com/Matches/1457613/Live/Brazil-Brasileirão-2020-Atletico-GO-Ceara
Ceara;421;26;151;77;195;57;252;142;110;252;39;215;9;9;1;0;27;Round 7 - Ceara x Fortaleza;https://1xbet.whoscored.com/Matches/1457624/Live/Brazil-Brasileirão-2020-Ceara-Fortaleza
Fortaleza;807;114;385;175;382;288;670;357;315;672;92;582;18;5;0;1;73;Round 7 - Ceara x Fortaleza;https://1xbet.whoscored.com/Matches/1457624/Live/Brazil-Brasileirão-2020-Ceara-Fortaleza
Goias;635;133;215;140;285;200;485;238;248;486;66;422;15;12;1;2;46;Round 7 - Goias x Corinthians ;https://1xbet.whoscored.com/Matches/1457625/Live/Brazil-Brasileirão-2020-Goias-Corinthians
Corinthians;702;152;256;158;354;211;565;289;276;565;55;511;29;11;2;1;54;Round 7 - Goias x Corinthians ;https://1xbet.whoscored.com/Matches/1457625/Live/Brazil-Brasileirão-2020-Goias-Corinthians
Fluminense;550;129;175;93;254;142;396;199;196;395;61;336;11;11;1;1;43;Round 7 - Fluminense x Atletico GO;https://1xbet.whoscored.com/Matches/1457612/Live/Brazil-Brasileirão-2020-Fluminense-Atletico-GO
Atletico GO;681;70;248;206;346;175;521;274;249;523;43;481;29;15;1;1;57;Round 7 - Fluminense x Atletico GO;https://1xbet.whoscored.com/Matches/1457612/Live/Brazil-Brasileirão-2020-Fluminense-Atletico-GO
Botafogo;695;64;314;185;358;196;554;274;282;556;52;511;21;17;0;0;54;Round 7 - Botafogo x Coritiba;https://1xbet.whoscored.com/Matches/1457611/Live/Brazil-Brasileirão-2020-Botafogo-RJ-Coritiba
Coritiba;624;100;244;122;295;168;463;229;235;464;57;409;16;7;0;0;46;Round 7 - Botafogo x Coritiba;https://1xbet.whoscored.com/Matches/1457611/Live/Brazil-Brasileirão-2020-Botafogo-RJ-Coritiba
Bahia;639;99;280;113;315;176;491;254;236;490;53;439;16;14;3;5;42;Round 7 - Bahia x Flamengo;https://1xbet.whoscored.com/Matches/1457622/Live/Brazil-Brasileirão-2020-Bahia-Flamengo
Flamengo;826;174;295;217;447;235;682;355;329;684;43;643;12;20;5;3;58;Round 7 - Bahia x Flamengo;https://1xbet.whoscored.com/Matches/1457622/Live/Brazil-Brasileirão-2020-Bahia-Flamengo
Athletico Paranaense;705;133;308;104;345;200;545;279;264;543;57;488;15;11;1;1;58;Round 7 - Athletico Paranaense x Red Bull;https://1xbet.whoscored.com/Matches/1457623/Live/Brazil-Brasileirão-2020-Athletico-Paranaense-Red-Bull-Bragantino
Red Bull;570;57;200;159;282;133;415;221;193;414;64;352;21;18;1;1;42;Round 7 - Athletico Paranaense x Red Bull;https://1xbet.whoscored.com/Matches/1457623/Live/Brazil-Brasileirão-2020-Athletico-Paranaense-Red-Bull-Bragantino
Santos;598;130;225;114;295;169;464;243;226;469;36;433;29;13;2;2;62;Round 7 - Santos x Vasco;https://1xbet.whoscored.com/Matches/1457609/Live/Brazil-Brasileirão-2020-Santos-FC-Vasco-da-Gama
Vasco;430;69;148;78;191;104;295;163;131;294;45;250;8;9;2;2;38;Round 7 - Santos x Vasco;https://1xbet.whoscored.com/Matches/1457609/Live/Brazil-Brasileirão-2020-Santos-FC-Vasco-da-Gama
Palmeiras;583;82;222;107;293;117;410;227;184;411;69;342;19;11;1;1;49;Round 7 - Palmeiras x Internacional;https://1xbet.whoscored.com/Matches/1457610/Live/Brazil-Brasileirão-2020-Palmeiras-Internacional
Internacional;594;79;233;122;284;149;433;224;208;432;66;368;11;8;1;1;51;Round 7 - Palmeiras x Internacional;https://1xbet.whoscored.com/Matches/1457610/Live/Brazil-Brasileirão-2020-Palmeiras-Internacional
Gremio;894;77;390;289;506;245;751;368;385;753;57;699;47;29;1;2;72;Round 7 - Gremio x Sport Recife;https://1xbet.whoscored.com/Matches/1457621/Live/Brazil-Brasileirão-2020-Gremio-Sport-Recife
Sport Recife;441;45;160;87;212;78;290;140;147;287;68;224;3;5;2;1;28;Round 7 - Gremio x Sport Recife;https://1xbet.whoscored.com/Matches/1457621/Live/Brazil-Brasileirão-2020-Gremio-Sport-Recife
Atletico Mg;675;130;253;141;327;196;523;265;256;521;80;444;13;14;3;0;51;Round 7 - Atletico Mg x Sao Paulo;https://1xbet.whoscored.com/Matches/1457608/Live/Brazil-Brasileirão-2020-Atletico-MG-Sao-Paulo
Sao Paulo;665;193;209;121;316;205;521;259;262;521;58;465;11;13;0;3;49;Round 7 - Atletico Mg x Sao Paulo;https://1xbet.whoscored.com/Matches/1457608/Live/Brazil-Brasileirão-2020-Atletico-MG-Sao-Paulo
Flamengo;697;55;286;223;361;201;562;290;273;563;27;537;32;18;2;1;62;Round 8 - Flamengo x Fortaleza;https://1xbet.whoscored.com/Matches/1457626/Live/Brazil-Brasileirão-2020-Flamengo-Fortaleza
Fortaleza;499;98;194;58;202;146;348;179;170;349;63;287;7;4;1;2;38;Round 8 - Flamengo x Fortaleza;https://1xbet.whoscored.com/Matches/1457626/Live/Brazil-Brasileirão-2020-Flamengo-Fortaleza
Corinthians;736;152;276;172;376;216;592;288;306;594;54;546;33;15;2;2;61;Round 8 - Corinthians x Botafogo;https://1xbet.whoscored.com/Matches/1457637/Live/Brazil-Brasileirão-2020-Corinthians-Botafogo-RJ
Botafogo;552;90;177;123;268;119;387;184;198;382;53;337;27;13;2;2;39;Round 8 - Corinthians x Botafogo;https://1xbet.whoscored.com/Matches/1457637/Live/Brazil-Brasileirão-2020-Corinthians-Botafogo-RJ
Ceara;601;50;267;155;313;157;470;241;228;469;46;426;24;16;0;1;61;Round 8 - Ceara x Santos;  https://1xbet.whoscored.com/Matches/1457628/Live/Brazil-Brasileir%C3%A3o-2020-Ceara-Santos-FC
Santos;463;79;154;71;220;84;304;156;144;300;45;259;17;7;1;0;39;Round 8 - Ceara x Santos;https://1xbet.whoscored.com/Matches/1457628/Live/Brazil-Brasileir%C3%A3o-2020-Ceara-Santos-FC
Red Bull;549;58;203;128;252;133;385;182;202;384;45;344;15;20;1;2;38;Round 8 - Red Bull x Palmeiras;https://1xbet.whoscored.com/Matches/1457638/Live/Brazil-Brasileir%C3%A3o-2020-Red-Bull-Bragantino-Palmeiras
Palmeiras;792;228;270;127;372;250;622;298;326;624;53;572;20;14;2;1;62;Round 8 - Red Bull x Palmeiras;https://1xbet.whoscored.com/Matches/1457638/Live/Brazil-Brasileir%C3%A3o-2020-Red-Bull-Bragantino-Palmeiras
Sao Paulo;634;104;264;136;323;174;497;262;141;403;47;457;13;15;3;1;50;Round 8 - Sao Paulo x Fluminense;https://1xbet.whoscored.com/Matches/1457634/Live/Brazil-Brasileir%C3%A3o-2020-Sao-Paulo-Fluminense
Fluminense;615;128;259;101;317;168;485;240;245;485;62;426;13;10;1;3;50;Round 8 - Sao Paulo x Fluminense;https://1xbet.whoscored.com/Matches/1457634/Live/Brazil-Brasileir%C3%A3o-2020-Sao-Paulo-Fluminense
Internacional;725;93;281;204;323;254;577;282;293;575;64;514;27;9;2;2;62;Round 8 - Internacional x Bahia;https://1xbet.whoscored.com/Matches/1457636/Live/Brazil-Brasileir%C3%A3o-2020-Internacional-Bahia
Bahia;518;84;195;91;265;105;370;198;165;363;50;320;15;9;2;2;38;Round 8 - Internacional x Bahia;https://1xbet.whoscored.com/Matches/1457636/Live/Brazil-Brasileir%C3%A3o-2020-Internacional-Bahia
Vasco;483;108;136;79;210;111;321;176;145;321;52;271;8;8;1;0;33;Round 8 - Vasco x Athletico Paranaense;https://1xbet.whoscored.com/Matches/1457627/Live/Brazil-Brasileir%C3%A3o-2020-Vasco-da-Gama-Athletico-Paranaense
Athletico Paranaense;774;162;270;213;419;224;643;316;329;645;48;597;19;14;0;1;67;Round 8 - Vasco x Athletico Paranaense;https://1xbet.whoscored.com/Matches/1457627/Live/Brazil-Brasileir%C3%A3o-2020-Vasco-da-Gama-Athletico-Paranaense
Atletico GO;634;88;244;162;319;174;493;252;241;493;62;432;17;8;1;1;49;Round 8 - Atletico GO x Gremio;https://1xbet.whoscored.com/Matches/1457629/Live/Brazil-Brasileir%C3%A3o-2020-Atletico-GO-Gremio
Gremio;645;81;267;171;335;178;513;273;245;518;58;461;22;6;1;1;51;Round 8 - Atletico GO x Gremio;https://1xbet.whoscored.com/Matches/1457629/Live/Brazil-Brasileir%C3%A3o-2020-Atletico-GO-Gremio
Coritiba;633;148;241;94;311;171;482;249;232;481;78;405;18;13;0;1;48;Round 8 - Coritiba x Atletico Mg;https://1xbet.whoscored.com/Matches/1457632/Live/Brazil-Brasileir%C3%A3o-2020-Coritiba-Atletico-MG
Atletico Mg;678;80;232;215;325;199;524;268;259;527;50;477;23;21;1;0;52;Round 8 - Coritiba x Atletico Mg;https://1xbet.whoscored.com/Matches/1457632/Live/Brazil-Brasileir%C3%A3o-2020-Coritiba-Atletico-MG
Sport Recife;673;71;286;178;336;193;529;246;282;528;58;477;29;18;2;1;53;Round 8 - Sport Recife x Goias;https://1xbet.whoscored.com/Matches/1457633/Live/Brazil-Brasileir%C3%A3o-2020-Sport-Recife-Goias
Goias;657;145;252;88;312;170;482;226;258;484;64;421;13;10;1;2;48;Round 8 - Sport Recife x Goias;https://1xbet.whoscored.com/Matches/1457633/Live/Brazil-Brasileir%C3%A3o-2020-Sport-Recife-Goias
Athletico Paranaense;668;122;279;151;343;198;541;271;269;540;45;497;17;17;1;1;62;Round 9 - Athletico Paranaemse x Botafogo;https://1xbet.whoscored.com/Matches/1457646/Live/Brazil-Brasileir%C3%A3o-2020-Athletico-Paranaense-Botafogo-RJ
Botafogo;489;103;161;92;228;125;353;180;175;355;47;309;17;11;1;1;38;Round 9 - Athletico Paranaemse x Botafogo;https://1xbet.whoscored.com/Matches/1457646/Live/Brazil-Brasileir%C3%A3o-2020-Athletico-Paranaense-Botafogo-RJ
Goias;642;101;224;188;309;202;511;243;267;510;49;464;28;18;3;3;54;Round 9 - Goias x Coritiba;https://1xbet.whoscored.com/Matches/1457644/Live/Brazil-Brasileir%C3%A3o-2020-Goias-Coritiba
Coritiba;595;107;214;106;273;153;426;208;216;424;60;367;16;14;3;3;46;Round 9 - Goias x Coritiba;https://1xbet.whoscored.com/Matches/1457644/Live/Brazil-Brasileir%C3%A3o-2020-Goias-Coritiba
Fortaleza;555;53;250;146;276;172;448;225;223;448;57;392;24;12;1;0;52;Round 9 - Fortaleza x Sport Recife;https://1xbet.whoscored.com/Matches/1457645/Live/Brazil-Brasileir%C3%A3o-2020-Fortaleza-Sport-Recife
Sport Recife;511;76;233;97;237;165;402;203;202;405;53;353;8;4;0;1;48;Round 9 - Fortaleza x Sport Recife;https://1xbet.whoscored.com/Matches/1457645/Live/Brazil-Brasileir%C3%A3o-2020-Fortaleza-Sport-Recife
Sao Paulo;696;102;269;183;361;191;552;285;269;554;42;512;36;14;1;1;59;Round 9 - Sao Paulo x Red Bull;https://1xbet.whoscored.com/Matches/1457635/Live/Brazil-Brasileir%C3%A3o-2020-Sao-Paulo-Red-Bull-Bragantino
Red Bull;545;82;225;79;255;129;384;197;188;385;66;320;7;10;1;1;41;Round 9 - Sao Paulo x Red Bull;https://1xbet.whoscored.com/Matches/1457635/Live/Brazil-Brasileir%C3%A3o-2020-Sao-Paulo-Red-Bull-Bragantino
Fluminense;661;86;261;143;306;179;485;245;242;487;50;440;24;17;1;2;47;Round 9 - Fluminense x Flamengo;https://1xbet.whoscored.com/Matches/1457630/Live/Brazil-Brasileir%C3%A3o-2020-Fluminense-Flamengo
Flamengo;716;113;278;150;339;200;539;283;258;541;55;486;17;13;2;1;53;Round 9 - Fluminense x Flamengo;https://1xbet.whoscored.com/Matches/1457630/Live/Brazil-Brasileir%C3%A3o-2020-Fluminense-Flamengo
Santos;483;72;154;106;225;107;332;165;167;332;52;280;11;8;3;1;41;Round 9 - Santos x Atletico Mg;https://1xbet.whoscored.com/Matches/1457639/Live/Brazil-Brasileir%C3%A3o-2020-Santos-FC-Atletico-MG
Atletico Mg;588;80;262;137;301;176;477;250;228;478;49;430;17;16;1;3;59;Round 9 - Santos x Atletico Mg;https://1xbet.whoscored.com/Matches/1457639/Live/Brazil-Brasileir%C3%A3o-2020-Santos-FC-Atletico-MG
Corinthians;688;140;281;132;343;210;553;307;246;553;44;509;17;10;0;2;54;Round 9 - Corinthians x Palmeiras;https://1xbet.whoscored.com/Matches/1457649/Live/Brazil-Brasileir%C3%A3o-2020-Corinthians-Palmeiras
Palmeiras;618;92;250;128;284;186;470;240;229;469;47;423;14;21;2;0;46;Round 9 - Corinthians x Palmeiras;https://1xbet.whoscored.com/Matches/1457649/Live/Brazil-Brasileir%C3%A3o-2020-Corinthians-Palmeiras
Internacional;722;128;273;170;342;227;569;292;275;567;72;499;24;17;2;0;62;Round 9 - Internacional x Ceara;https://1xbet.whoscored.com/Matches/1457648/Live/Brazil-Brasileir%C3%A3o-2020-Internacional-Ceara
Ceara;499;48;185;128;263;96;359;182;177;359;61;300;18;6;0;2;38;Round 9 - Internacional x Ceara;https://1xbet.whoscored.com/Matches/1457648/Live/Brazil-Brasileir%C3%A3o-2020-Internacional-Ceara
Bahia;639;83;296;134;329;184;513;264;249;513;30;483;24;17;0;2;50;Round 9 - Bahia x Gremio;https://1xbet.whoscored.com/Matches/1457647/Live/Brazil-Brasileir%C3%A3o-2020-Bahia-Gremio
Gremio;637;89;300;120;301;207;508;248;259;507;48;461;13;18;2;0;50;Round 9 - Bahia x Gremio;https://1xbet.whoscored.com/Matches/1457647/Live/Brazil-Brasileir%C3%A3o-2020-Bahia-Gremio
Vasco;640;93;291;119;299;201;500;256;244;500;62;441;10;9;1;2;54;Round 9 - Vasco x Atletico GO;https://1xbet.whoscored.com/Matches/1457631/Live/Brazil-Brasileir%C3%A3o-2020-Vasco-da-Gama-Atletico-GO
Atletico GO;554;82;199;145;282;142;424;208;217;425;44;382;21;13;2;1;46;Round 9 - Vasco x Atletico GO;https://1xbet.whoscored.com/Matches/1457631/Live/Brazil-Brasileir%C3%A3o-2020-Vasco-da-Gama-Atletico-GO
Athletico Paranaense;542;75;213;115;241;162;403;201;202;403;62;341;23;10;1;0;44;Round 10 - Athletico Paranaense x Coritiba;https://1xbet.whoscored.com/Matches/1457650/Live/Brazil-Brasileir%C3%A3o-2020-Athletico-Paranaense-Coritiba
Coritiba;648;181;221;108;314;193;507;256;252;508;58;452;22;5;0;1;56;Round 10 - Athletico Paranaense x Coritiba;https://1xbet.whoscored.com/Matches/1457650/Live/Brazil-Brasileir%C3%A3o-2020-Athletico-Paranaense-Coritiba
Santos;577;100;226;123;281;166;447;240;209;449;67;382;19;10;2;2;55;Round 10 - Santos x Sao Paulo;https://1xbet.whoscored.com/Matches/1457640/Live/Brazil-Brasileir%C3%A3o-2020-Santos-FC-Sao-Paulo
Sao Paulo;514;90;186;100;234;140;374;216;156;372;58;318;14;12;2;2;45;Round 10 - Santos x Sao Paulo;https://1xbet.whoscored.com/Matches/1457640/Live/Brazil-Brasileir%C3%A3o-2020-Santos-FC-Sao-Paulo
Fluminense;539;60;209;118;247;139;386;199;187;386;39;348;14;15;2;1;48;Round 10 - Fluminense x Corinthians;https://1xbet.whoscored.com/Matches/1457643/Live/Brazil-Brasileir%C3%A3o-2020-Fluminense-Corinthians
Corinthians;562;102;206;113;253;166;419;205;214;419;54;367;17;9;1;2;52;Round 10 - Fluminense x Corinthians;https://1xbet.whoscored.com/Matches/1457643/Live/Brazil-Brasileir%C3%A3o-2020-Fluminense-Corinthians
Gremio;696;50;315;210;351;216;567;292;281;573;26;549;23;14;1;1;56;Round 10 - Gremio x Fortaleza;https://1xbet.whoscored.com/Matches/1457652/Live/Brazil-Brasileir%C3%A3o-2020-Gremio-Fortaleza
Fortaleza;573;91;283;71;257;186;443;222;222;444;37;398;9;3;1;1;44;Round 10 - Gremio x Fortaleza;https://1xbet.whoscored.com/Matches/1457652/Live/Brazil-Brasileir%C3%A3o-2020-Gremio-Fortaleza
Atletico Mg;751;155;282;259;367;228;595;298;293;591;55;541;19;14;2;1;64;Round 10 - Atletico Mg x Red Bull;https://1xbet.whoscored.com/Matches/1457653/Live/Brazil-Brasileir%C3%A3o-2020-Atletico-MG-Red-Bull-Bragantino
Red Bull;502;69;176;101;244;101;345;169;173;342;57;289;14;12;1;2;36;Round 10 - Atletico Mg x Red Bull;https://1xbet.whoscored.com/Matches/1457653/Live/Brazil-Brasileir%C3%A3o-2020-Atletico-MG-Red-Bull-Bragantino
Ceara;551;56;221;103;253;126;379;187;191;378;67;313;11;8;2;0;37;Round 10 - Ceara x Flamengo;https://1xbet.whoscored.com/Matches/1457654/Live/Brazil-Brasileir%C3%A3o-2020-Ceara-Flamengo
Flamengo;793;119;271;241;406;218;624;333;296;629;51;580;30;11;0;2;63;Round 10 - Ceara x Flamengo;https://1xbet.whoscored.com/Matches/1457654/Live/Brazil-Brasileir%C3%A3o-2020-Ceara-Flamengo
Goias;336;67;62;54;144;39;183;100;83;183;57;126;2;6;1;0;22;Round 10 - Goias x Internacional;https://1xbet.whoscored.com/Matches/1457656/Live/Brazil-Brasileir%C3%A3o-2020-Goias-Internacional
Internacional;738;59;265;328;391;261;652;316;336;652;40;612;57;15;0;1;78;Round 10 - Goias x Internacional;https://1xbet.whoscored.com/Matches/1457656/Live/Brazil-Brasileir%C3%A3o-2020-Goias-Internacional
Bahia;632;110;238;125;316;156;472;243;228;471;45;428;14;9;0;1;53;Round 10 - Bahia x Atletico GO;https://1xbet.whoscored.com/Matches/1457651/Live/Brazil-Brasileir%C3%A3o-2020-Bahia-Atletico-GO
Atletico GO;563;121;169;132;288;134;422;199;222;421;43;382;18;12;1;0;47;Round 10 - Bahia x Atletico GO;https://1xbet.whoscored.com/Matches/1457651/Live/Brazil-Brasileir%C3%A3o-2020-Bahia-Atletico-GO
Palmeiras;742;57;365;198;380;239;619;290;328;618;47;573;22;20;2;2;64;Round 10 - Palmeiras x Sport Recife;https://1xbet.whoscored.com/Matches/1457641/Live/Brazil-Brasileir%C3%A3o-2020-Palmeiras-Sport-Recife
Sport Recife;511;93;193;76;230;131;361;178;179;357;56;306;11;9;2;2;37;Round 10 - Palmeiras x Sport Recife;https://1xbet.whoscored.com/Matches/1457641/Live/Brazil-Brasileir%C3%A3o-2020-Palmeiras-Sport-Recife
Botafogo;636;102;231;142;317;158;475;236;236;472;57;418;28;25;2;3;50;Round 10 - Botafogo x Vasco;https://1xbet.whoscored.com/Matches/1457642/Live/Brazil-Brasileir%C3%A3o-2020-Botafogo-RJ-Vasco-da-Gama
Vasco;673;83;255;148;300;185;485;254;231;485;55;431;14;14;3;2;50;Round 10 - Botafogo x Vasco;https://1xbet.whoscored.com/Matches/1457642/Live/Brazil-Brasileir%C3%A3o-2020-Botafogo-RJ-Vasco-da-Gama